111111
10E001
1P0001
10C001
111111
