1111111111111
1000000000001
1000011100001
100000E000001
100C000000P01
1000000000001
1000010000101
1111111111111
