1111111111111
1000000000001
1000000000001
100000E000001
100C000000P01
1000000000001
10000C0000C01
1111111111111
