1111111111111111111111
10000000000111000E0001
1111100001100001010101
1001000000000000000001
1P110000000000000C0001
1111111111111111111111
