1111111111
10P0000001
1000000001
10001000E1
1000000001
1111111111
